########
#      #
# #  # #
# #  # #
# #  # #
# #  # #
#      #
########